000000000000000000000000000100000000010000000000000000000000111
000000000000000000000000000100000000110000000000111100000000111
000000000000000000000000001100000011000000000000111100001111111
000000000000000000000000001100001111100000000000000000101111111
000000000000000000000000001100001101111100000000000010100000111
000000000000000000000001011111001101111100000000000010000000111
000000000000000000000000001111000000001000000000000000000000111
000000000000000000000000001111000000000000000000000000000000111
000000000000000000000000011111111111000000000000000000000001111
000000000000000000000000111111111111110000000000000000000001111
000000000000000000000001111111111111111000000000000000000111111
000000000000000000000001111111111111111000000000000000011111111
001110000000000000000001111111111111111000000000000001111111111
111111000000000000000000011111111111110000000000000011111111111
111111000000000000000000001111111111100000000000000001111111111
011111111100000000000000000001111100000000000000000001111111111
000001111110000000000000000001110000000000000000000000111111111
000001111110000000000000000001110000000000000000000000111111111
000001111110000000000000000000000000000000000000000000011111111
000001111000000000000000000000000000000000000000000000001111111
000001111100000000000000000000000000000000000000000000000111111
000011111110000000000000000000000000000000000000000000000111111
000011111110000000000000000000000000000000000000000000000011111
000011111110000000000000000000000000000000000000000000000001111
000001111111100000000000000000000000000000000000000000000001111
000000011111100000000000000000000000000000000000000000000001111
000000111111100000000000000000000000000000000011000000000011111
000000111011000000000000000000000000000000001111000011111111111
000000111000000000000000000000000000000110001100111111111111111
000000010000000000000000000000000000000110000111111110111001111
000000000000000000000000000000000011010110001111100000010001111
000000000000000000000000000000000011010110001110000000000000111
000000000000000000000000000000000000000110001111100000000000111
000000000000000000111101000000000001100000001101100000000000000
010101001000111111111111110110111111110000110100000000000000000
111111111101111111111111111111111010111111110000000000000000000
111111111111111111111111111110000000000000000000000000000000000
011111111111111111111111111000000000000000000000000000000000000
001111111111111111111111100000000000000000000000000000000000000
000000000000011000111011000000000000000000000000000000000000000
