000000000000100000001101000000000000000001000000000000000000
000000000000000000001100000000000100000000000000000000100000
000000000000000000000000000000000010000000000000000000000000
100010000000000000010000111000000010000100000000000000000010
000000000000000010000100001000000010011010000000000000001000
000000000000010010000000000000000000010100010010100001000010
000000000000000000000000100000001000000000000000000000010000
000000100000000000000000000001000001000000000001000010000010
000100001010000000000000000000010000000000000000010100000000
000000000000000000000000000000000000010000100000001000000010
100010001000000000000000000000000000100000000000100000000000
000000000000001010000000000000000000000000000000000000000000
000000000000011000000000000000001000000000001000110000010000
000000000000000000010000100001000000000000000101001010000010
000000000000010000001001100000001000000001000100000000000000
000000000000000000000000100000000000000000001000000001000000
000000000000001000000000000000100000100000000000000000100000
000000000100000000100000000000000000001100000000000000000000
000000000000000000001000000010000000000111000000000001000000
000000000000000001100000010000000000000000000000000000010100
000100000000000000000100100000000000010001000000000101000001
000000000100001000000000000000100000000000000000010000000100
000000000100100000000000010000101000000000000000001000000000
000000000000000000000100000000010000010100000010000000001000
000000010000000100010001010000000101001001000000000000000000
000000000000000000010000000001000000000100000000000000000000
001000000000010100000010000100000000001000000000000000001010
000000000000000000000000000000100000000000000001000100000100
000000000000001000000100000010000000000001000010000000001001
000000000100000000000000000000010001000000000000100000000000
000000000001100000000100000100000100010000010000000000100000
000000000000001000000010000000100000000000000000000010010000
000000001001010000000000000001100001000000010000000010000001
000101000000000000000000001000000101000000000000000000000000
000000000001000000000000000000000001000000000000000000000110
000000010000000000000000000000000000000000000001000010000100
101000000000000000000000010000010000000000000100000001000000
000000000100100000000000000000001000000001010000000110100000
000000000000001000000000010010000000100000001000000000000000
000000000000000000001001000000000000000000010010000000100000
000000000000000000100000000000000000000100000000000101000000
001100000000000100100000000011001000010000100000000000100000
000000000010000010000000000001000010001000000000000000000010
001000000001000000000001100000000001000010000000000000000000
000000000000001001000000000000000000100001010000000000000000
000000000000000000010000000001000001110000000000000000000000
001100000100000001000000000000000000010100010000000001001000
000000000000000000110000100000000000000000010000000000000000
000000000000000000000000000000000000100000000000011000000000
000000000001000000000000000000000000100010001000100000000000
010000000000000000000000000000000100100000010001000100001000
000000000000000000100001000000000000000000000000010000000000
000000000000000000000000000010000000000000000000000000000001
000000000000000000100001000100000001000000000000000000000100
000000000000000000000000000000100000000000000101000000110000
100001000001000000000000000000000000000001000000000000000000
000000100000000000000000000000001000010010001000000000000001
000000000000010000000000010100000010010000010000010000001010
000010000000001000100010000100000010010000000010000110010010
000000000000000100000000000000000011000000100000000000000000