00000000000010000000110
00000000000000000000110
00000000000000000000000
10001110000000000001000
00111110000000001000011
11111111100001001000011